0, 0, 0, 0, 0, 0, 0, 0, 0, 0, 1, 1, 2, 2, 2, 2, 2, 2, 2, 2,
0, 0, 1, 0, 0, 0, 0, 0, 0, 0, 0, 1, 1, 2, 2, 2, 2, 2, 2, 2,
0, 1, 1, 0, 0, 1, 0, 0, 0, 0, 0, 0, 1, 2, 2, 2, 2, 2, 2, 2,
0, 0, 0, 0, 1, 1, 1, 0, 0, 0, 0, 0, 1, 2, 2, 2, 2, 2, 2, 2,
0, 0, 0, 0, 1, 1, 1, 0, 0, 0, 0, 0, 0, 0, 2, 2, 2, 2, 2, 2,
0, 0, 0, 0, 0, 1, 0, 0, 0, 0, 0, 0, 0, 0, 0, 2, 2, 2, 2, 1,
0, 0, 0, 0, 0, 0, 0, 0, 0, 0, 0, 0, 0, 0, 0, 0, 4, 4, 4, 4,
0, 0, 0, 0, 0, 0, 1, 1, 0, 0, 1, 1, 0, 0, 0, 0, 4, 4, 4, 4,
2, 2, 0, 0, 4, 4, 4, 1, 0, 0, 0, 1, 0, 0, 0, 4, 4, 4, 4, 4,
2, 2, 2, 0, 4, 4, 4, 1, 0, 0, 0, 1, 1, 0, 0, 4, 4, 4, 4, 4,
2, 2, 1, 4, 4, 4, 4, 0, 0, 0, 0, 0, 0, 0, 0, 4, 4, 4, 4, 4,
0, 1, 1, 4, 0, 0, 0, 0, 0, 1, 0, 0, 0, 0, 0, 4, 4, 4, 4, 4,
0, 0, 1, 0, 0, 0, 0, 0, 1, 1, 1, 0, 0, 0, 0, 0, 4, 4, 4, 4,
0, 0, 0, 0, 0, 0, 0, 0, 0, 0, 1, 0, 0, 0, 0, 0, 4, 4, 4, 4,
0, 0, 0, 0, 0, 1, 0, 0, 0, 0, 0, 0, 0, 0, 0, 2, 2, 2, 2, 1,
0, 0, 0, 0, 1, 1, 1, 0, 0, 0, 0, 0, 0, 0, 2, 2, 2, 2, 2, 2,
0, 0, 0, 0, 1, 1, 1, 0, 0, 0, 0, 0, 1, 2, 2, 2, 2, 2, 2, 2,
0, 0, 0, 0, 0, 1, 0, 0, 0, 0, 0, 0, 1, 2, 2, 2, 2, 2, 2, 2,
0, 0, 0, 0, 0, 0, 0, 0, 0, 0, 0, 1, 1, 2, 2, 2, 2, 2, 2, 2,
0, 0, 0, 0, 0, 0, 0, 0, 0, 0, 1, 1, 2, 2, 2, 2, 2, 2, 2, 2,:
9, 4, 12, 5, 4, 2, 1, 4,/ 6, 2, 15, 6,/ 0, 0,:
9, 15, 12, 14, 4, 17, 1, 15,/ 6, 17, 15, 13,/ 0, 19,:
20, 20,: